111111111111111111
100P11111100000E11
100C111111000C0011
100000G000000GCG11
10000000E0000G0G11
100011111111100111
10C0111110CCC00011
111111110E00000011
111111111111111111
