11111111
1E0000C1
100C0001
10000001
1P000001
11111111
