1111111111111
1000000000P01
1EC0000G00001
1111111111111
