111111111111111111111
1000000000P111000E001
10C0000G00011G0000001
1000C00000011100000G1
100000G000011111CCC11
10000000000C000000G11
111111111111111111111
