1111111111111
1000000000P01
1EC0000G00001
1000000000001
100000G000001
10G000000G001
1111111111111
