11111111
10E00001
1000P001
10C00001
11111111
