11111111111111111111111
100000000P1000000000011
100000000010000000E0011
100000C0000000C11100011
1000000000111111110P011
11111111111111111111111
