111111111111111111
100P11111100000E11
100C111111000C0011
1000000000000GC011
10000000E0000G0011
111111111111111111
