111111111111111111111111
1CE0P0000000000000000001
100000000000000000000001
100000000000000000000001
1000000000000000000000E1
10000000000000C000000001
100000011111111110000001
111111111111111111111111
