11111111111111111111111
1CCCCCCCCC1CCCCCCCCCC11
1CCCCCCCCC1CCCCCCCECC11
1CCCCCCCCCCCCCC111CCC11
1CCCCCCCCC11111111CPC11
11111111111111111111111
